#### acc=access
accbala=account balance
#### acce=access
acct=account
addr=address
#### adj=null
admin=administrator
amt=amount
app=application
assoc=associate
associat=associate
attr=attribute
attrb=attribute
attrib=attribute
bene=benefit
cat=category
cd=code
#### cdc=null
col=column
compon=component
cond=condition
config=configue
#### constr=constraint
cont=contact
contr=contract
contxt=context
#### cur=currency
curr=current
#### def=define
desc=description
desig=design
#### disab=disable
#### dist=distance
distrib=distribute
doc=document
dt=date
#### dwl=null
edu=education
eng=english
ent=entity
equiv=equal
err=error
excl=exclude
ext=extension
fld=field 
freq=frequency
grp=group
hier=hierarchy
ident=identity
imp=implement
impl=implement
implem=implement
inact=inactivated
#### ind=index
#### inq=null
#### int=internal
#### irrevoc=irrevocable
lang=language
loc=location
lvl=level
meth=method
mthd=method
nm=name
notif=notify
num=number
obj=object
#### op=null
org=organization
param=parameter
paym=payment
poten=potential
pref=prefix
#### prod=product
prov=provider
pub=publication
pymt=payment
#### reas=null
ref=reference
#### rej=reject
rel=relation
relev=relevance
req=request
resp=response
#### seg=null
seq=sequence
serv=service
src=source
st=status
#### susp=suspect
sys=system
tm=time
tp=type
#### trans=transaction
#### txn=null
#### ult=null
undel=undeliverable
val=value
#### ver=null